11 11
0 0 0 0 0 0 0 0 0 0 0 
0 1 1 * 1 0 0 2 2 2 0 
0 1 1 1 1 * * 2 2 2 0 
0 1 * * 1 * * 2 * * 0 
0 1 1 1 1 0 0 2 2 2 0 
0 1 1 1 1 0 0 2 5 5 0 
0 0 0 0 0 0 * * 0 * 0 
0 * 0 * 0 0 0 0 0 0 0 
0 * 6 * 0 7 4 * * 8 0 
0 6 6 3 0 7 4 * * 8 0 
0 0 0 0 0 0 0 0 0 0 0 
