20 20
0 0 0 0 0 0 0 0 0 0 0 0 0 0 0 0 0 0 0 0 
0 * * 0 0 2 2 2 0 0 3 * * 0 0 * 4 * 4 0 
0 * * 0 0 * 2 * 0 0 3 * * 0 0 4 4 * 4 0 
0 0 0 0 0 0 0 0 0 0 0 0 0 0 0 0 0 0 0 0 
0 0 0 0 0 0 0 0 0 0 0 0 0 0 0 0 0 0 0 0 
0 5 5 0 0 * 6 0 0 * 7 * 7 0 0 * * 8 * 0 
0 * * 0 0 * 6 0 0 7 7 7 7 0 0 8 8 8 8 0 
0 * * 0 0 6 6 0 0 * * 7 * 0 0 * 8 * 8 0 
0 5 5 0 0 * * 0 0 * * 7 * 0 0 0 0 0 0 0 
0 0 0 0 0 0 0 0 0 0 0 0 0 0 0 0 0 0 0 0 
0 0 0 0 0 0 0 0 0 0 0 0 0 0 0 9 * 9 * 0 
0 10 * * 10 * 0 0 11 11 11 11 11 0 0 9 9 9 9 0 
0 10 * * 10 * 0 0 * 11 * 11 * 0 0 9 9 * * 0 
0 10 10 10 10 10 0 0 * 11 11 11 * 0 0 * 9 * * 0 
0 0 0 0 0 0 0 0 0 0 0 0 0 0 0 0 0 0 0 0 
0 0 0 0 0 0 0 0 0 0 0 0 0 0 0 0 0 0 0 0 
0 12 * 12 * 12 12 0 0 * * 13 * 0 0 14 14 14 14 0 
0 12 12 12 12 12 * 0 0 13 13 13 * 0 0 14 * * 14 0 
0 * 12 * * 12 * 0 0 * 13 13 13 0 0 14 * * 14 0 
0 0 0 0 0 0 0 0 0 0 0 0 0 0 0 0 0 0 0 0 
