30 30
0 0 0 0 0 0 0 0 0 0 0 0 0 0 * * 0 0 0 0 0 0 0 0 0 * * 0 * * 
0 1 1 0 * 2 2 2 0 * * 3 * 3 3 0 0 4 4 0 0 5 5 0 0 6 6 6 6 0 
0 1 1 0 0 2 2 2 * * 3 3 3 * 3 * 0 4 4 * * 5 5 0 0 6 * 6 6 0 
0 1 1 0 * * 2 2 0 0 3 3 * 3 3 0 0 4 4 0 0 5 5 0 0 6 6 6 6 0 
0 0 0 0 0 0 0 0 0 0 0 0 0 0 0 0 0 0 0 0 0 0 0 0 0 0 0 0 0 0 
0 0 0 0 0 0 0 0 0 0 0 0 0 0 0 0 0 0 0 0 0 0 0 0 0 0 0 0 0 0 
0 7 7 0 0 8 8 8 0 0 9 9 9 9 0 0 10 0 0 11 11 11 0 0 12 0 0 13 13 0 
0 7 7 0 0 8 8 8 0 0 9 9 9 9 0 0 0 0 0 11 11 11 0 0 12 0 0 13 13 0 
0 7 7 0 0 8 8 8 0 0 9 9 9 9 0 0 0 0 0 11 11 11 0 0 12 0 0 13 13 0 
0 7 7 0 0 8 8 8 0 0 9 9 9 9 0 0 14 0 0 0 0 0 0 0 0 0 0 0 0 0 
0 7 7 0 0 8 8 8 0 0 0 0 0 0 0 0 0 0 0 0 0 0 0 0 0 0 0 0 0 0 
0 0 0 0 0 0 0 0 0 0 0 0 0 0 0 0 0 0 0 15 15 15 0 0 16 0 0 17 17 0 
0 0 0 0 0 0 0 0 0 0 18 18 18 18 0 0 19 0 0 15 15 15 0 0 16 0 0 17 17 0 
0 20 20 0 0 21 21 21 0 0 18 18 18 18 0 0 19 0 0 15 15 15 0 0 16 0 0 17 17 0 
0 20 20 0 0 21 21 21 0 0 18 18 18 18 0 0 19 0 0 15 15 15 0 0 16 0 0 17 17 0 
0 20 20 0 0 21 21 21 0 0 0 0 0 0 0 0 0 0 0 0 0 0 0 0 0 0 0 0 0 0 
0 20 20 0 0 0 0 0 0 0 0 0 0 0 0 0 0 0 0 0 0 0 0 0 0 0 0 0 0 0 
0 0 0 0 0 0 0 0 0 0 22 0 0 23 23 23 23 0 0 24 0 0 25 25 25 0 0 26 26 0 
0 0 0 0 0 27 27 27 0 0 22 0 0 23 23 23 23 0 0 24 0 0 25 25 25 0 0 26 26 0 
0 28 28 0 0 0 0 0 0 0 0 0 0 0 0 0 0 0 0 0 0 0 0 0 0 0 0 26 26 0 
0 28 28 0 0 0 0 0 0 0 0 0 0 0 0 0 0 0 0 0 0 0 0 0 0 0 0 26 26 0 
0 28 28 0 0 29 29 29 0 0 30 30 30 0 0 31 31 0 0 32 0 0 33 33 33 0 0 0 0 0 
0 28 28 0 0 29 29 29 0 0 30 30 30 0 0 31 31 0 0 32 0 0 33 33 33 0 0 0 0 0 
0 0 0 0 0 29 29 29 0 0 0 0 0 0 0 0 0 0 0 0 0 0 0 0 0 0 0 34 34 0 
0 0 0 0 0 0 0 0 0 0 0 0 0 0 0 0 0 0 0 0 0 0 0 0 0 0 0 34 34 0 
0 35 35 0 0 0 0 0 0 0 36 0 0 37 37 37 0 0 38 0 0 39 39 39 39 0 0 0 0 0 
0 35 35 0 0 40 40 40 0 0 36 0 0 37 37 37 0 0 38 0 0 39 39 39 39 0 0 0 0 0 
0 35 35 0 0 40 40 40 0 0 36 0 0 37 37 37 0 0 38 0 0 39 39 39 39 0 0 41 41 0 
0 35 35 0 0 40 40 40 0 0 36 0 0 37 37 37 0 0 38 0 0 39 39 39 39 0 0 41 41 0 
0 0 0 0 0 0 0 0 0 0 0 0 0 0 0 0 0 0 0 0 0 0 0 0 0 0 0 0 0 0 
