15 15
0 0 0 0 0 0 0 0 0 0 0 0 0 0 0 
0 1 1 0 0 * 0 0 * 0 0 * 4 * 0 
0 * * 0 0 2 0 0 * 0 0 * 4 * 0 
0 0 0 0 0 0 0 0 0 0 0 0 0 0 0 
0 0 0 0 0 0 0 0 0 0 0 0 0 0 0 
0 * * 0 0 * 0 0 7 0 0 8 8 * 0 
0 5 5 0 0 6 0 0 * 0 0 * 8 8 0 
0 5 5 0 0 * 0 0 * 0 0 8 8 8 0 
0 * * 0 0 * 0 0 7 0 0 * * 8 0 
0 * * 0 0 6 0 0 * 0 0 * * 8 0 
0 0 0 0 0 0 0 0 0 0 0 0 0 0 0 
0 0 0 0 0 0 0 0 0 0 0 0 0 0 0 
0 * * 0 0 * * 10 10 10 0 0 11 * 0 
0 * * 0 0 * * 10 * * 0 0 11 11 0 
0 0 0 0 0 0 0 0 0 0 0 0 0 0 0 
